1000000000000000000000000
1000000000000000000000000
0001000000000000000000000
0001000000001000000000000
0001000000001000000010000
0001111000001000000010000
0000000000001000000010000
0000000000001000000000000
0000000000001000000000000
0000000000000000000000000
0000000000000000000000000
0000000000001111111000000
0000100000000000001000000
0000100000000000001000000
0000100000000000001000000
0000000000000000000000000
0000000000000000000000001